24,15,"level 1"
0,11 ,0,11,0,11,0,11,0,11,0,11,0,11,0,11,0,11,0,11,0,11,0,2 ,0,3 ,0,11,0,11,0,11,0,11,0,11,0,11,0,11,0,11,0,11,0,11,0,11
0,11 ,0,9 ,0,4 ,0,4 ,0,4 ,0,4 ,0,4 ,0,4 ,0,4 ,0,4 ,0,4 ,0,0 ,0,0 ,0,4 ,0,4 ,0,4 ,0,4 ,0,4 ,0,4 ,0,4 ,0,4 ,0,4 ,0,8 ,0,11
0,11 ,0,2 ,0,0 ,0,0 ,0,0 ,0,0 ,0,0 ,0,0 ,0,1 ,0,0 ,0,0 ,0,0 ,0,0 ,0,0 ,0,0 ,0,1 ,0,0 ,0,0 ,0,0 ,0,0 ,0,0 ,0,0 ,0,3 ,0,11
0,11 ,0,2 ,0,0 ,0,10,0,0 ,0,0 ,0,0 ,0,0 ,0,0 ,0,0 ,0,0 ,0,0 ,0,0 ,0,0 ,0,0 ,0,0 ,0,0 ,0,0 ,0,0 ,0,0 ,0,10,0,0 ,0,3 ,0,11
0,11 ,0,2 ,0,0 ,0,0 ,0,0 ,0,15,0,11,0,11,0,11,0,11,0,12,0,0 ,0,0 ,0,15,0,11,0,11,0,11,0,11,0,12,0,0 ,0,0 ,0,0 ,0,3 ,0,11
0,11 ,0,2 ,0,0 ,0,0 ,0,0 ,0,11,0,11,0,11,0,11,0,11,0,11,0,0 ,0,0 ,0,11,0,11,0,11,0,11,0,11,0,11,0,0 ,0,0 ,0,0 ,0,3 ,0,11
0,4  ,0,0 ,0,0 ,0,0 ,0,0 ,0,11,0,11,0,11,0,11,0,11,0,11,0,0 ,0,0 ,0,11,0,11,0,11,0,11,0,11,0,11,0,0 ,0,0 ,0,0 ,0,0 ,0,4
0,0  ,0,0 ,0,0 ,0,1 ,0,0 ,0,11,0,11,0,11,0,11,0,11,0,11,0,0 ,0,0 ,0,11,0,11,0,11,0,11,0,11,0,11,0,0 ,0,0 ,0,1 ,0,0 ,0,0
0,5  ,0,0 ,0,0 ,0,0 ,0,0 ,0,11,0,11,0,11,0,11,0,11,0,11,0,0 ,0,0 ,0,11,0,11,0,11,0,11,0,11,0,11,0,0 ,0,0 ,0,0 ,0,0 ,0,5
0,11 ,0,2 ,0,0 ,0,0 ,0,0 ,0,11,0,11,0,11,0,11,0,11,0,11,0,0 ,0,0 ,0,11,0,11,0,11,0,11,0,11,0,11,0,0 ,0,0 ,0,0 ,0,3 ,0,11
0,11 ,0,2 ,0,0 ,0,0 ,0,0 ,0,14,0,11,0,11,0,11,0,11,0,13,0,0 ,0,0 ,0,14,0,11,0,11,0,11,0,11,0,13,0,0 ,0,0 ,0,0 ,0,3 ,0,11
0,11 ,0,2 ,0,0 ,0,10,0,0 ,0,0 ,0,0 ,0,0 ,0,0 ,0,0 ,0,0 ,0,0 ,0,0 ,0,0 ,0,0 ,0,0 ,0,0 ,0,0 ,0,0 ,0,0 ,0,10,0,0 ,0,3 ,0,11
0,11 ,0,2 ,0,0 ,0,0 ,0,0 ,0,0 ,0,0 ,0,0 ,0,1 ,0,0 ,0,0 ,0,0 ,0,0 ,0,0 ,0,0 ,0,1 ,0,0 ,0,0 ,0,0 ,0,0 ,0,0 ,0,0 ,0,3 ,0,11
0,11 ,0,6 ,0,5 ,0,5 ,0,5 ,0,5 ,0,5 ,0,5 ,0,5 ,0,5 ,0,5 ,0,0 ,0,0 ,0,5 ,0,5 ,0,5 ,0,5 ,0,5 ,0,5 ,0,5 ,0,5 ,0,5 ,0,7 ,0,11
0,11 ,0,11,0,11,0,11,0,11,0,11,0,11,0,11,0,11,0,11,0,11,0,2 ,0,3 ,0,11,0,11,0,11,0,11,0,11,0,11,0,11,0,11,0,11,0,11,0,11
