8,5,"test level 6"
0,2,0,4,0,4,0,4,0,4,0,4,0,4,0,3
0,2,0,0,0,0,0,0,0,0,0,0,0,0,0,3
0,2,0,1,0,0,0,0,0,0,0,0,0,0,0,3
0,2,0,0,0,0,0,0,0,0,0,0,0,0,0,3
0,2,0,5,0,5,0,5,0,5,0,5,0,5,0,3