20,13,"level obstacles"
0,11 ,2,11 ,2,11 ,2,11 ,2,11 ,2,11 ,2,11 ,2,11 ,2,11 ,2,11 ,2,11 ,2,11 ,2,11 ,2,11 ,2,11 ,2,11 ,2,11 ,2,11 ,2,11 ,2,11
0,11 ,2,9  ,2,4  ,2,4  ,2,4  ,2,4  ,2,4  ,2,4  ,2,4  ,2,4  ,2,4  ,2,4  ,2,4  ,2,4  ,2,4  ,2,4  ,2,4  ,2,4  ,2,8  ,2,11
0,11 ,2,2  ,2,26 ,2,0  ,2,0  ,2,26 ,2,0  ,2,0  ,2,26 ,2,0  ,2,0  ,2,26 ,2,0  ,2,0  ,2,26 ,2,0  ,2,0  ,2,26 ,2,3  ,2,11
0,11 ,2,2  ,2,0  ,2,1  ,2,0  ,2,0  ,2,1  ,2,0  ,2,0  ,2,0  ,2,0  ,2,0  ,2,0  ,2,1  ,2,0  ,2,0  ,2,1  ,2,0  ,2,3  ,2,11
0,11 ,2,2  ,2,0  ,2,0  ,2,10 ,2,0  ,2,0  ,2,10 ,2,0  ,2,0  ,2,0  ,2,0  ,2,10 ,2,0  ,2,0  ,2,10 ,2,0  ,2,0  ,2,3  ,2,11
0,11 ,2,2  ,2,0  ,2,0  ,2,0  ,2,0  ,2,0  ,2,0  ,2,0  ,2,0  ,2,0  ,2,0  ,2,0  ,2,0  ,2,0  ,2,0  ,2,0  ,2,0  ,2,3  ,2,11
0,11 ,2,2  ,2,26 ,2,0  ,2,0  ,2,26 ,2,0  ,2,0  ,2,26 ,2,0  ,2,0  ,2,26 ,2,0  ,2,0  ,2,26 ,2,0  ,2,0  ,2,26 ,2,3  ,2,11
0,11 ,2,2  ,2,0  ,2,0  ,2,0  ,2,0  ,2,0  ,2,0  ,2,0  ,2,0  ,2,0  ,2,0  ,2,0  ,2,0  ,2,0  ,2,0  ,2,0  ,2,0  ,2,3  ,2,11
0,11 ,2,2  ,2,0  ,2,0  ,2,10 ,2,0  ,2,0  ,2,10 ,2,0  ,2,0  ,2,0  ,2,0  ,2,10 ,2,0  ,2,0  ,2,10 ,2,0  ,2,0  ,2,3  ,2,11
0,11 ,2,2  ,2,0  ,2,1  ,2,0  ,2,0  ,2,1  ,2,0  ,2,0  ,2,0  ,2,0  ,2,0  ,2,0  ,2,1  ,2,0  ,2,0  ,2,1  ,2,0  ,2,3  ,2,11
0,11 ,2,2  ,2,26 ,2,0  ,2,0  ,2,26 ,2,0  ,2,0  ,2,26 ,2,0  ,2,0  ,2,26 ,2,0  ,2,0  ,2,26 ,2,0  ,2,0  ,2,26 ,2,3  ,2,11
0,11 ,2,6  ,2,5  ,2,5  ,2,5  ,2,5  ,2,5  ,2,5  ,2,5  ,2,5  ,2,5  ,2,5  ,2,5  ,2,5  ,2,5  ,2,5  ,2,5  ,2,5  ,2,7  ,2,11
0,11 ,2,11 ,2,11 ,2,11 ,2,11 ,2,11 ,2,11 ,2,11 ,2,11 ,2,11 ,2,11 ,2,11 ,2,11 ,2,11 ,2,11 ,2,11 ,2,11 ,2,11 ,2,11 ,2,11
