21,13,"level  walls 2"
1,23 ,1,20 ,1,20 ,1,20 ,1,20 ,1,20 ,1,20 ,1,20 ,1,20 ,1,20 ,1,20 ,1,20 ,1,20 ,1,20 ,1,20 ,1,20 ,1,20 ,1,20 ,1,20 ,1,20 ,1,24
1,21 ,1,10 ,1,0  ,1,0  ,1,0  ,1,0  ,1,0  ,1,0  ,1,0  ,1,0  ,1,0  ,1,0  ,1,0  ,1,0  ,1,0  ,1,0  ,1,0  ,1,0  ,1,0  ,1,10  ,1,21
1,21 ,1,0  ,1,0  ,1,1  ,1,0  ,1,10 ,1,0  ,1,0  ,1,1  ,1,0  ,1,10 ,1,0  ,1,1  ,1,0  ,1,0  ,1,10 ,1,0  ,1,1  ,1,0  ,1,0  ,1,21
1,21 ,1,0  ,1,0  ,1,0  ,1,0  ,1,21 ,1,0  ,1,0  ,1,0  ,1,0  ,1,21 ,1,0  ,1,0  ,1,0  ,1,0  ,1,21 ,1,0  ,1,0  ,1,0  ,1,0  ,1,21
1,21 ,1,0  ,1,0  ,1,0  ,1,0  ,1,21 ,1,0  ,1,0  ,1,0  ,1,0  ,1,21 ,1,0  ,1,0  ,1,0  ,1,0  ,1,21 ,1,0  ,1,0  ,1,0  ,1,0  ,1,21
1,21 ,1,0  ,1,0  ,1,0  ,1,10 ,1,21 ,1,10 ,1,0  ,1,0  ,1,10 ,1,21 ,1,10 ,1,0  ,1,0  ,1,10 ,1,21 ,1,10 ,1,0  ,1,0  ,1,0  ,1,21
1,21 ,1,10 ,1,0  ,1,20 ,1,20 ,1,26 ,1,20 ,1,0  ,1,0  ,1,20 ,1,26 ,1,20 ,1,0  ,1,0  ,1,20 ,1,26 ,1,20 ,1,20 ,1,0  ,1,10 ,1,21
1,21 ,1,0  ,1,0  ,1,0  ,1,10 ,1,21 ,1,10 ,1,0  ,1,0  ,1,10 ,1,21 ,1,10 ,1,0  ,1,0  ,1,10 ,1,21 ,1,10 ,1,0  ,1,0  ,1,0  ,1,21
1,21 ,1,0  ,1,0  ,1,0  ,1,0  ,1,21 ,1,0  ,1,0  ,1,0  ,1,0  ,1,21 ,1,0  ,1,0  ,1,0  ,1,0  ,1,21 ,1,0  ,1,0  ,1,0  ,1,0  ,1,21
1,21 ,1,0  ,1,0  ,1,0  ,1,0  ,1,21 ,1,0  ,1,0  ,1,0  ,1,0  ,1,21 ,1,0  ,1,0  ,1,0  ,1,0  ,1,21 ,1,0  ,1,0  ,1,0  ,1,0  ,1,21
1,21 ,1,0  ,1,0  ,1,1  ,1,0  ,1,10 ,1,0  ,1,0  ,1,1  ,1,0  ,1,10 ,1,0  ,1,1  ,1,0  ,1,0  ,1,10 ,1,0  ,1,1  ,1,0  ,1,0  ,1,21
1,21 ,1,10 ,1,0  ,1,0  ,1,0  ,1,0  ,1,0  ,1,0  ,1,0  ,1,0  ,1,0  ,1,0  ,1,0  ,1,0  ,1,0  ,1,0  ,1,0  ,1,0  ,1,0  ,1,10  ,1,21
1,22 ,1,20 ,1,20 ,1,20 ,1,20 ,1,20 ,1,20 ,1,20 ,1,20 ,1,20 ,1,20 ,1,20 ,1,20 ,1,20 ,1,20 ,1,20 ,1,20 ,1,20 ,1,20 ,1,20 ,1,25
