20,13,"test level 1"
2,11 ,2,11 ,2,11 ,2,11 ,2,11 ,2,11 ,2,11 ,2,11 ,2,11 ,2,11 ,2,11 ,2,11 ,2,11 ,2,11 ,2,11 ,2,11 ,2,11 ,2,11 ,2,11 ,2,11
2,11 ,2,9 ,2,4 ,2,4 ,2,4 ,2,4 ,2,4 ,2,4 ,2,4 ,2,4 ,2,4 ,2,4 ,2,4 ,2,4 ,2,4 ,2,4 ,2,4 ,2,4 ,2,8 ,2,11
2,11 ,2,2 ,2,0 ,2,0 ,2,0 ,2,0 ,2,0 ,2,0 ,2,0 ,2,0 ,2,0 ,2,0 ,2,0 ,2,0 ,2,0 ,2,0 ,2,0 ,2,0 ,2,3 ,2,11
2,11 ,2,2 ,2,0 ,2,1 ,2,0 ,2,10 ,2,20 ,2,10 ,2,20 ,2,10 ,2,20 ,2,10 ,2,20 ,2,10 ,2,20 ,2,0 ,2,1 ,2,0 ,2,3 ,2,11
2,11 ,2,2 ,2,0 ,2,0 ,2,0 ,2,0 ,2,0 ,2,0 ,2,0 ,2,0 ,2,0 ,2,0 ,2,0 ,2,0 ,2,0 ,2,0 ,2,0 ,2,0 ,2,3 ,2,11
2,11 ,2,2 ,2,0 ,2,0 ,2,0 ,2,0 ,2,0 ,2,0 ,2,0 ,2,0 ,2,0 ,2,0 ,2,0 ,2,0 ,2,0 ,2,0 ,2,0 ,2,0 ,2,3 ,2,11
2,11 ,2,2 ,2,18 ,2,19 ,2,0 ,2,20 ,2,10 ,2,20 ,2,10 ,2,20 ,2,10 ,2,20 ,2,10 ,2,20 ,2,10 ,2,0 ,2,18 ,2,19 ,2,3 ,2,11
2,11 ,2,2 ,2,0 ,2,0 ,2,0 ,2,0 ,2,0 ,2,0 ,2,0 ,2,0 ,2,0 ,2,0 ,2,0 ,2,0 ,2,0 ,2,0 ,2,0 ,2,0 ,2,3 ,2,11
2,11 ,2,2 ,2,0 ,2,0 ,2,0 ,2,0 ,2,0 ,2,0 ,2,0 ,2,0 ,2,0 ,2,0 ,2,0 ,2,0 ,2,0 ,2,0 ,2,0 ,2,0 ,2,3 ,2,11
2,11 ,2,2 ,2,0 ,2,1 ,2,0 ,2,10 ,2,20 ,2,10 ,2,20 ,2,10 ,2,20 ,2,10 ,2,20 ,2,10 ,2,20 ,2,0 ,2,1 ,2,0 ,2,3 ,2,11
2,11 ,2,2 ,2,0 ,2,0 ,2,0 ,2,0 ,2,0 ,2,0 ,2,0 ,2,0 ,2,0 ,2,0 ,2,0 ,2,0 ,2,0 ,2,0 ,2,0 ,2,0 ,2,3 ,2,11
2,11 ,2,6 ,2,5 ,2,5 ,2,5 ,2,5 ,2,5 ,2,5 ,2,5 ,2,5 ,2,5 ,2,5 ,2,5 ,2,5 ,2,5 ,2,5 ,2,5 ,2,5 ,2,7 ,2,11
2,11 ,2,11 ,2,11 ,2,11 ,2,11 ,2,11 ,2,11 ,2,11 ,2,11 ,2,11 ,2,11 ,2,11 ,2,11 ,2,11 ,2,11 ,2,11 ,2,11 ,2,11 ,2,11 ,2,11
