20,14,"level walls"
1,23 ,1,20 ,1,20 ,1,20 ,1,20 ,1,20 ,1,20 ,1,20 ,1,20 ,1,20 ,1,20 ,1,20 ,1,20 ,1,20 ,1,20 ,1,20 ,1,20 ,1,20 ,1,20 ,1,24
1,21 ,1,0 ,1,0 ,1,0 ,1,0 ,1,0 ,1,0 ,1,0 ,1,0 ,1,0 ,1,0 ,1,0 ,1,0 ,1,0 ,1,0 ,1,0 ,1,0 ,1,0 ,1,0 ,1,21
1,21 ,1,0 ,1,1 ,1,0 ,1,0 ,1,0 ,1,0 ,1,0 ,1,0 ,1,0 ,1,0 ,1,0 ,1,0 ,1,0 ,1,0 ,1,0 ,1,0 ,1,1 ,1,0 ,1,21
1,21 ,1,0 ,1,0 ,1,15 ,1,12 ,1,0 ,1,0 ,1,0 ,1,0 ,1,0 ,1,0 ,1,0 ,1,0 ,1,0 ,1,0 ,1,15 ,1,12 ,1,0 ,1,0 ,1,21
1,21 ,1,0 ,1,0 ,1,11 ,1,11 ,1,0 ,1,0 ,1,0 ,1,0 ,1,0 ,1,0 ,1,0 ,1,0 ,1,0 ,1,0 ,1,11 ,1,11 ,1,0 ,1,0 ,1,21
1,21 ,1,0 ,1,0 ,1,11 ,1,11 ,1,11 ,1,11 ,1,11 ,1,11 ,1,11 ,1,11 ,1,11 ,1,11 ,1,11 ,1,11 ,1,11 ,1,11 ,1,0 ,1,0 ,1,21
1,21 ,1,0 ,1,0 ,1,11 ,1,11 ,1,11 ,1,11 ,1,11 ,1,11 ,1,11 ,1,11 ,1,11 ,1,11 ,1,11 ,1,11 ,1,11 ,1,11 ,1,0 ,1,0 ,1,21
1,21 ,1,0 ,1,0 ,1,11 ,1,11 ,1,11 ,1,11 ,1,11 ,1,11 ,1,11 ,1,11 ,1,11 ,1,11 ,1,11 ,1,11 ,1,11 ,1,11 ,1,0 ,1,0 ,1,21
1,21 ,1,0 ,1,0 ,1,11 ,1,11 ,1,11 ,1,11 ,1,11 ,1,11 ,1,11 ,1,11 ,1,11 ,1,11 ,1,11 ,1,11 ,1,11 ,1,11 ,1,0 ,1,0 ,1,21
1,21 ,1,0 ,1,0 ,1,11 ,1,11 ,1,0 ,1,0 ,1,0 ,1,0 ,1,0 ,1,0 ,1,0 ,1,0 ,1,0 ,1,0 ,1,11 ,1,11 ,1,0 ,1,0 ,1,21
1,21 ,1,0 ,1,0 ,1,14 ,1,13 ,1,0 ,1,0 ,1,0 ,1,0 ,1,0 ,1,0 ,1,0 ,1,0 ,1,0 ,1,0 ,1,14 ,1,13 ,1,0 ,1,0 ,1,21
1,21 ,1,0 ,1,1 ,1,0 ,1,0 ,1,0 ,1,0 ,1,0 ,1,0 ,1,0 ,1,0 ,1,0 ,1,0 ,1,0 ,1,0 ,1,0 ,1,0 ,1,1 ,1,0 ,1,21
1,21 ,1,0 ,1,0 ,1,0 ,1,0 ,1,0 ,1,0 ,1,0 ,1,0 ,1,0 ,1,0 ,1,0 ,1,0 ,1,0 ,1,0 ,1,0 ,1,0 ,1,0 ,1,0 ,1,21
1,22 ,1,20 ,1,20 ,1,20 ,1,20 ,1,20 ,1,20 ,1,20 ,1,20 ,1,20 ,1,20 ,1,20 ,1,20 ,1,20 ,1,20 ,1,20 ,1,20 ,1,20 ,1,20 ,1,25
